!----------------------------------------------------------------------!
!----------------------------------------------------------------------!
!----------------------------------------------------------------------!
!-----------------f----------------------------------------------------!
!----------------------------------------------------------------------!
!----------------------------------------------------------------------!
!-------------------------------------------------#-------##---------f-!
!----------------##--------------#------#-----#---------##..#----------!
!------ssss-----#..#-------------.------.------------###.....#---------!
################....#####---#####.######.############.........###--#####
.........................---....................................----....
.........................---....................................----....
.........................---....................................----....
.........................---....................................----....
.........................---....................................----....
.........................---....................................----....