!----------------------------------------------------------------------!
!----------------------------------------------------------------------!
!----------------------------------------------------------------------!
!----------------------------------------------------------------------!
!----------------------------------------------------------------------!
!----------------------------------------------------------------------!
!-------------------------------------------------#-------##-----------!
!----------------##--------------#------#-----#---------##..#----------!
!---------------#..#-------------.------.------------###.....#---------!
################....#####---#####.######.############.........###--#####
.........................---....................................----....
.........................---....................................----....
.........................---....................................----....
.........................---....................................----....
.........................---....................................----....
.........................---....................................----....