---------------------------------------------------------------------
---------------------------------------------------------------------
---------------------------------------------------------------------
---------------------------------------------------------------------
---------------------------------------------------------------------
---------------------------------------------------------------------
---------------------------------------------------------------------
----------------------------------------------------------##---------
-----------------##-------------------------------------##..#--------
----------------#..#---------------------------------###.....#-------
################....#################################.........#######
.....................................................................
.....................................................................
.....................................................................
.....................................................................
.....................................................................
.....................................................................