!----------------------------------------------------------------------!
!----------------------------------------------------------------------!
!----------------------------------------------------------------------!
!----------------------------------------------------------------------!
!----------------------------------------------------------------------!
!--------------------------------------------------------------------f-!
!-----------------v-------------------------------#-------##-----------!
!----------------##--------------#------#-----#---------##..#----------!
!---ssssss------#..#-------------.------.--ssssssss--###.....#------v--!
################....#####---#####.######.############.........###--#####
.........................---....................................----....
.........................---....................................----....
.........................---....................................----....
.........................---....................................----....
.........................---....................................----....
.........................---....................................----....