!----------------------------------------------------------------------!
!----------------------------------------------------------------------!
!--------------------###-----------------------------------------------!
!-----------------------##-------------------------------##------------!
!-------------------------#--------------------------------#-----------!
!--------------------------#------#----------------------------------f-!
!-----------#---#----#-----------...------#------------#---------------!
!-------#------------.------#------------#.------#--#---------##-------!
!-------.------------.------.-----------#..#---------------------------!
####--##.############.##################....##--##--#########...########
....--..................................................................
....--..................................................................
....--..................................................................
....--..................................................................
....--..................................................................
....--..................................................................