------------------------------------------------------------------------
---------------------#--------------------------------------------------
----------------------##------------------------------------------------
------------------------##-------------------------------##-------------
--------------------------##-------------------------------#------------
----------------------------------#----------------------------------f--
---------------#-----#-----------#.#------#------------#----------------
--------#-----#------.------#------------#.------#--#---------##--------
@-------.------------.------.-----------#..#---------------------------@
####--##.#####--#####.######.###########....######--#########...########
....--........--........................................................
....--........--........................................................
....--........--........................................................
....--........--........................................................
....--........--........................................................
....--........--........................................................