!----------------------------------------------------------------------!
!----------------------------------------------------------------------!
!-------------############-----################------------------------!
!------------#-----------#-----#-------------------------##------------!
!-----------#------------#-----#---------------------------#-----------!
!----------#-------------#-----#-------------------------------------f-!
!---------#-#---#----#---#-----#-----------------------#---------------!
!--------#-----------.---#-----#-----------------#--#---------##-------!
!-------#------------.---#-----#---------------------------------------!
########.############.####-----#########################################
....--....................-----.........................................
....--....................-----.........................................
....--....................-----.........................................
....--....................-----.........................................
....--....................-----.........................................
....--....................-----.........................................